SOOOOOOOOO
XXXXXXXXXO
XXXXXXXXXO
XXXXXXXXXO
XXXXXXXXXO
XXXXXXXXXO
XXXXXXXXXE