SOXXXXXXXX
OOOXXXXXXX
OXOOOXOOOO
XXXXOXOXXO
OOOOOOOXXO
OXXOXXXXXO
OOOOXXXXXE