SOXXXXXXXXXXXX
XOXXXXXXXXXXXX
XOXXOOOOXXXXXX
XOXXOXXOXXXXXX
XOOOOXXOXXXXXX
XXXXXXXOOOOOXX
XXXXXXXXXXXOXX
XXXXXXXXXXXOOE